111111111111111111111111111
121000000000100000000000001
101011111110101111111110101
100010000010100000000010101
111110101010111110111110101
100010101010001000100010101
101011101011101111101010101
101000001000100000001000101
101111111110111111111111101
101000000010001000001010001
101011111111101110101010111
101000001000101000100010001
101011101010101011111111101
101000100010000010000000101
101111111111111110111011101
100010000000000010100010001
101010111111111010101110111
101010000000101000101000101
101011111110101111101011101
101000001000100010001010001
111110101011111010111011101
100000101000001010001010001
101111101111101011101010101
100000100000100010100010101
101110111111111010111110101
100010000000000000000000131
111111111111111111111111111
