1111111111111111
1210001000100011
1010101010101011
1010101010101011
1010101010101011
1010101010101011
1000100010001000
1111111111111113
